 _   _       _   _    _            _     _
| \ | |     | | | |  | |          | |   | |
|  \| |_   _| | | |  | | ___  _ __| | __| |
| . ` | | | | | | |/\| |/ _ \| '__| |/ _` |
| |\  | |_| | | \  /\  / (_) | |  | | (_| |
\_| \_/\__,_|_|  \/  \/ \___/|_|  |_|\__,_|

                                           